---
ss_path: assets/spritesheets/tiles.dat
offset_x: -256
offset_y: -160
---
222222222222222222222222222222222222224
222222222222222222222222222222222222224
222222222222222222222222222222222222224
222222222222222222222226111111111111174
222222222222222222222224-------------34
222222222222222222222224-------------34
222222222261111111111174-------------34
22222222224-----------BC-------------BC
22222222224----------------------------
22222222224----------------------------
22222222224----------------------------
22222222225000000000000000000000000000A
222222222222222222222222222222222222224
222222222222222222222222222222222222224
222222222222222222222222222222222222224
222222222222222222222222222222222222224
222222222222222222222222222222222222224
222222222222222222222222222222222222224