assets/spritesheets/tiles.dat,-32,0
2----------------------------2
2----------------------------2
2000-----000-----------------2
2----0-----------------------2
2----2-----------------------2
2----20-----------000--------2
200002200000000000222000000002
222222222222222222222222222222